05 09 01 02
0 0 0 0 0 1 0 0 0
2 0 0 1 0 0 0 1 0
0 0 1 1 0 0 1 0 0
0 0 0 0 0 1 0 0 0
0 1 0 0 0 1 0 0 3