15 09 01 01
2 0 0 0 0 0 0 0 0
1 0 0 0 0 0 0 0 0
1 0 0 0 0 0 0 0 0
1 1 1 0 0 0 0 0 0
0 0 1 0 0 0 0 0 0
0 0 1 1 1 0 0 0 0
0 0 0 0 1 0 0 0 0
0 0 0 0 1 1 1 0 0
0 0 0 0 1 0 0 0 0
0 0 1 1 1 0 0 0 0
0 0 1 0 0 0 0 0 0
1 1 1 0 0 0 0 0 0
1 0 0 0 0 0 0 0 0
1 0 0 0 0 0 0 0 0
3 0 0 0 0 0 0 0 0